########00
#x..o..#00
#..##.####
#a.#.o...#
#........#
#..#######
####000000   