0############
0#.......x.x#
0#.o#########
##..#00000000
#@.o#00000000
#...#00000000
#####00000000