#######
#.....#
#..o..#
#.....#
#@...x#
#######